                                                                                         E
                                    A                                                    E
                                    A              I                                     E
                                    A              I                                     E
                                    A        EF    I                                     E
                   IIIIIII  IIIIIII A              I                                     E
            II                      A IIIII IIII   I BBBBBBBBBBBBBBBBBBBBBBBBBBBBBB      E      
                              EBBBBF               I                  EF                 E
                 EF      IIII             EF       I          B     EF           BGDII   E
        EF      CD                 CD      CD      EGAD     * B                   B      E
BBBBBBBBGHBBBBBBBGHBBBBBBBBBBBBBBBBBBBGHBBBBBBBBBBBBBBBBBBBBBBBGHBBBBBBBBBBGAAHBBBBBBBBBBB